NO ./textures/no_1.xpm
SO ./textures/so_1.xpm
WE ./textures/we_1.xpm
EA ./textures/ea_1.xpm
F 0,0,255
C 255,255,0

1111111111111111111111111
1000000000110000000000001
101100N001110000000000001
1001000000000000000000001
1111111110110000011100001
1111111111111111111111111
